1412121212121
1000000000002
1000003000001
2000000000002
2000300000001
1000000003002
1000000000001
1412121212121